rows 35
cols 25
players 2
city 0 1
city 1 0

m .........................
m .........................
m .........................
m .........................
m ........a...C...a........
m .........................
m ..........a...a..........
m .........................
m ............a............
m .........................
m .........................
m .........................
m .........................
m .........................
m .........................
m .........................
m .........................
m .........................
m .........................
m .........................
m .........................
m .........................
m .........................
m .........................
m .........................
m .........................
m .........................
m .........................
m .........................
m .........................
m .......b....I....b.......
m .........................
m .........................
m .........................
m .........................